S..##TE..##T.
#.#..#..###..
...E..#..####
..###......#T
#.##...E..##E
...#..#...##.
.T...E..#...G