S.###..E.T#.#E
#E.#..#.#.#...
##.#.##.#E##.T
##..E.#.#....#
###...#.##..##
###T#...#.E.##
#T..E.#...#.##
####..##....EG

