S..#...E.T
#T.#..#.#.
#....E#.#E
#.E...#.#.
###T#...#G
