S..#.ET..##
#.#..###.E.
..E...##...
##..T...E..
T###..###.#
E....#E...G